G G R R G G W W S S S S S S S S S S S S
G G R R G G W W S S S S S S S S S S S S
G G R R G G W W S S S S S S S S S S S S
G G R R G G W W S S S S S S S S S S S S
G G R R G G W W S S S S S S S S S S S S
G G R R G G W W S S S S S S S S S S S S
G G R R G G W W S S S S S H H S S S S S
G G R R G G W W S S S S S H H S S S S S
G G R R G G W W A A A A A F F A A A A A
G G R R G G W W G G G W W B B W W G G G
G G R R G G W W W W W W W B B W W W W W
G G R R G G W W W W W W W B B W W W W W
G G R R G G W W W W W W W B B W W W W W
G G R R G G W W G G G W W B B W W G G G
G G R R G G W W G G G G D U R G G G G G
G G R R G G W W G G G G R D U G G G G G
G G R R G G W W G G G G R R W G G G G G
G G R R G G W W G G G G R R G G G G G G
G G R R G G W W G G G G R R G G G G G G
G G R R G G W W G G G W R R G G G G G G
G G R R G G W W G G G G R R G G G G G G
G G R R G G W W G G G G R R G G G G G G
G G R R G G W W G G G G R R G G G G G G
G G R R G G W W G G G G R R G G W W G G
G G R R G G W W G G G G R R G G G G G G
G G R R G G W W G G G W R R G G G G G G
G G R C P P B B P P P P U R G G G G G G
G G C P P P B B P P P P P U G G G G W W
G G G G G G W W G G G G G G G G G G W W
G G G G G G W W G G G G G G G G G G G W
G G G G G G W W G G G G G G G G G G W W
